habitar : to inhabit
abundar :  to abound
menospreciar : to underestimate, despise
exclamar : to exclaim
incapacitar : to incapacitate, disable
aclarar : to clarify
inspirar : to inspire
marchar : to march
bailar : to dance
inspeccionar : to inspect, scan sth., examine
acomodar : to accommodate
exportar : to export
nominar : to nominate
mejorar : to improve, enhance
aconsejar : to advise
bajar : to lower, decrease
observar :to observe, notice
acostumbrar : to accustom
motivar : to motivate, inspire
incitar : to incite, encourage, prompt
activar : to activate
burlar : to cheat
acumular :to accumulate
lastimar : to hurt, harm
causar : to cause, create
adaptar : to adapt
ba単ar : to bathe, coat sth.
adelantar : to forward
narrar : to tell, narrate
adivinar : to guess
capacitar : to train
afirmar : to claim
jurar : to swear, vow
afrontar : to face
besar : to kiss
agotar : to sell out
captar : to get
agravar : to aggravate
juntar : to join, gather
agrupar : to group
ignorar : to ignore, disregard
aguantar : to endure
limar : to file, polish
ilusionar :to  deceive
aguardar : to wait for
meditar : to meditate, reflect
ahorrar : to save
brindar : to give
aislar : to isolate
intentar : to try, attempt
alejar : to take away
cenar : to have dinner, dine
alertar : to alert 
igualar : to match
almacenar : to store
doblar : to bend, double, fold
alojar : to host
brillar : to shine
inclinar : to tilt, tip sth.
calcular : to calculate
nombrar : to name, appoint
lavar : to wash, rinse
animar : to animate
brotar : to sprout
instalar : to install
anotar : to take notes
citar : to quote sb./sth.
monitorear : to monitor, track
anticipar : to anticipate
incentivar : to incentivize
anular : to cancel
drenar : to drain
apartar : to separate
imaginar : to imagine
apelar : to appeal
duchar : to shower
modelar : to model, shape
aportar : to provide
negociar : to negotiate, deal
llenar : to fill, populate
apoyar : to support
cantar : to sing
menear : to wag, swish
aprovechar : to take advantage
involucrar : to involve, engage
donar : to donate, give
aproximar : to approach
lapidar :to  stone
mapear : to map
crear : to create
iniciar : to start, begin, initiate
argumentar : to argue
evitar : to avoid
innovar : to innovate
notar : to note, notice
mordisquear : to chew
arrastrar : to drag
curar : to cure, heal
arrojar : to throw
da単ar : to damage, harm, injure
influenciar : to influence, bias
asegurar : to secure
moldear : to mold
explotar : to exploit, develop
asomar : to show, peek
depositar : to deposit, deliver
acariciar : to caress
intimidar : to intimidate, bully
aliviar : to alleviate
dejar : to stop, quit
apreciar : to appreciate
hablar : to speak, talk
asociar : to associate
laminar : to laminate
maquinar : to engineer, intrigue
infiltrar : to infiltrate
desayunar : to have breakfast
abonar : to pay, fertilise
desear : to desire, wish
ladrar : to bark
abordar : to address, approach, tackle
incomodar : to discomfort sb.
abortar : to abort, cancel
descansar : to rest
abrumar : to overcome, overwhelm, exhaust
envenenar : to poison
mencionar : to mention, name
incorporar : to incorporate
labrar :to  plow
abusar : to abuse, misuse
limpiar : to clean, wipe
acabar : to finish, end, stop
multar : to fine, ticket
inhabilitar : to disable
acampar : to camp, go camping
linchar : to lynch
acelerar : to accelerate, speed up, expedite
inhalar : to inhale
liberar : to release, unleash
aceptar : to accept, agree to, take sb./sth
llorar : to cry, weep
acompa単ar :to  accompany, go with sb., join sb./sth.
incrementar : to increase, augment
calmar : to calm
liderar : to lead, pioneer
maniobrar : to maneuver
acusar : to accuse sb. of sth., blame sb. for sth.
manipular : to manipulate, tamper
adeudar : to owe
incubar : to hatch, incubate
callar : to silence
administrar : to manage, administer, dispense
heredar : to inherit
mirar : to look, gaze
infectar : to infect
admirar : to admire, look up
lidiar : to deal, cope
estudiar : to study, examine
cambiar : to change
mimar : to pamper, spoil
legislar : to legislate, enact laws
adobar : to baste sth, pickle sth
incrustar : to embed
adoptar : to adopt
expirar : to expire
adornar : to decorate, garnish
manejar : to drive, handle
caminar : to walk
licitar : to bid
afamar : to promote, fame
esperar : to wait
migrar : to migrate
afectar : to affect, influence sb./sth.
humectar : to moisturize
afilar : to sharpen
cancelar :to  cancel
nadar : to swim
levitar : to levitate
afinar : to refine, tune up
estorbar : to hinder sb./sth.
cansar : to get tired
aflojar :to loosen, undo sth.
irradiar : to radiate, shine
lloviznar : to drizzle [impersonal verb]
estafar : to defraud
agachar : to bend
obrar : to work, act
bordar : to embroider
capturar : to capture
agarrar : to grab, grasp, take
enflorar : to adorn with flowers
agitar : to shake, agitate, stir
casar : to marry
ajustar : to adjust, adapt
insultar : to insult
alabar :to  praise, commend
estimar : to estimate, cost, calculate
alarmar : to alarm, startle sb., frighten sb./sth.
llamar : to call, summon
alegrar : to cheer up, brighten sb./sth.
enrollar : to roll, wind, coil
alimentar : to nurture, feed, fuel
jalar : to pull
alisar : to smooth, straighten
intercalar : to insert, intersperse
alistar : to get ready
limitar : to limit, restrict
alquilar : to rent
honrar : to honor, grace
alterar : to alter, change
idear : to devise, design
amar : to love
laborar : to work
mezclar : to mix, blend
amputar : to amputate, cut off
humillar : to humiliate
amueblar : to furnish
matricular : to register, enroll
anhelar : to long, wish, look forward
irritar : to irritate, annoy
anunciar : to announce, advertise, declare
holgazanear : to slack
inyectar : to inject
apestar : to smell, stink
necesitar : to need, require
apilar : to stack, pile
ilustrar : to illustrate
aplastar : to crush
emigrar : to migrate
manchar : to stain, soil
invalidar : to invalidate, override
apuntar : to aim
empujar : to push sb./sth., shove sb./sth.)
apurar : to hasten
molestar : to disturb, annoy
ara単ar : to scratch
lograr : to achieve, reach, accomplish
arar : to plough
mandar : to send, order
hurtar : to steal
inaugurar : to inaugurate, open
armar : to build
llevar : to carry, conduct
arreglar : to fix, arrange, repair
intercambiar : to exchange, swap
arropar : to wrap up
impulsar : to drive, boost, push, power
elogiar : to commend, praise
articular : to articulate
habilitar : to enable sb./sth.
asar : to roast, grill sth.
grabar : to record
invitar : to invite
asear : to tidy sth. up
luchar : to fight, strive
golpear : to hit sb./sth.
asesorar : to advise, counsel sb./sth.
obsequiar :to give, treat
improvisar : to improvise
elaborar : to develop, prepare sth.
asignar : to assign, allocate
girar : to turn
asimilar : to assimilate, take sth. in
impresionar : to impress
echar : to pour
aspirar : to pursue sth., vacuum sth.
imposibilitar : to preclude
gastar : to spend
asustar : to frighten, scare
editar : to edit, modify sth.
atar : to tie, bind sb./sth.
maltratar : to mistreat, abuse
invalidar : to invalidate, override
atornillar : to screw
egresar : to graduate
importar : to import, matter, care
malinterpretar : to misinterpret, misunderstand
atrapar : to catch, trap
ganar : to win, gain, earn
nublar : to blur
auditar : to audit
magullar : to bruise
ejercitar : to exercise, train sb./sth.
implementar : to implement
aumentar : to increase, enhance
fumar : to smoke
irrespetar : to disrespect, ignore
objetar : to object, refute
madurar : to mature, ripen
ayudar : to help, assist sb./sth.
impactar : to impact
borrar : to delete, erase
noquear : to knock out